"TotalDrivingEfficiency_RANKTHISWEEK_2014","TotalDrivingEfficiency_RANKLASTWEEK_2014","TotalDrivingEfficiency_PLAYERNAME_2014","TotalDrivingEfficiency_ROUNDS_2014","TotalDrivingEfficiency_COMBINEDRANK_2014","TotalDrivingEfficiency_CARRYEFFICIENCYRANK_2014","TotalDrivingEfficiency_TOTALDISTEFFICRANK_2014","stat_name","year"
1,1,"Bud Cauley",56,4,2,2,"TotalDrivingEfficiency",2014
2,2,"Hunter Mahan",88,6,3,3,"TotalDrivingEfficiency",2014
3,3,"Webb Simpson",87,9,8,1,"TotalDrivingEfficiency",2014
4,4,"Davis Love III",74,11,5,6,"TotalDrivingEfficiency",2014
5,5,"Mark Wilson",69,16,7,9,"TotalDrivingEfficiency",2014
6,6,"Ernie Els",85,28,22,6,"TotalDrivingEfficiency",2014
6,6,"Hideki Matsuyama",82,28,17,11,"TotalDrivingEfficiency",2014
8,8,"Ryan Palmer",85,30,6,24,"TotalDrivingEfficiency",2014
9,9,"Billy Horschel",92,32,8,24,"TotalDrivingEfficiency",2014
9,9,"Geoff Ogilvy",84,32,17,15,"TotalDrivingEfficiency",2014
11,11,"Zach Johnson",97,37,34,3,"TotalDrivingEfficiency",2014
11,11,"Josh Teater",90,37,15,22,"TotalDrivingEfficiency",2014
13,13,"Brian Davis",93,38,29,9,"TotalDrivingEfficiency",2014
14,14,"Morgan Hoffmann",103,39,12,27,"TotalDrivingEfficiency",2014
15,15,"Jordan Spieth",102,43,38,5,"TotalDrivingEfficiency",2014
16,16,"Ben Crane",81,48,19,29,"TotalDrivingEfficiency",2014
16,16,"Wes Roach",67,48,24,24,"TotalDrivingEfficiency",2014
18,18,"Will Ma Kenzie",82,49,20,29,"TotalDrivingEfficiency",2014
19,19,"Nicholas Thompson",85,53,34,19,"TotalDrivingEfficiency",2014
20,20,"Bill Haas",107,54,25,29,"TotalDrivingEfficiency",2014
21,21,"Jason Day",54,55,1,54,"TotalDrivingEfficiency",2014
21,21,"JB Holmes",86,55,10,45,"TotalDrivingEfficiency",2014
21,21,"Chris Kirk",105,55,20,35,"TotalDrivingEfficiency",2014
24,24,"Vijay Singh",83,58,13,45,"TotalDrivingEfficiency",2014
25,25,"Brian Harman",111,63,51,12,"TotalDrivingEfficiency",2014
25,25,"Heath Slocum",71,63,55,8,"TotalDrivingEfficiency",2014
25,25,"Tim Wilkinson",86,63,43,20,"TotalDrivingEfficiency",2014
28,28,"Dustin Johnson",58,64,22,42,"TotalDrivingEfficiency",2014
28,28,"Scott Stallings",77,64,16,48,"TotalDrivingEfficiency",2014
30,30,"Martin Laird",66,67,32,35,"TotalDrivingEfficiency",2014
31,31,"Jeff Maggert",54,69,51,18,"TotalDrivingEfficiency",2014
31,31,"Jimmy Walker",98,69,56,13,"TotalDrivingEfficiency",2014
33,33,"Sean OHair",77,71,4,67,"TotalDrivingEfficiency",2014
34,34,"Justin Rose",70,72,11,61,"TotalDrivingEfficiency",2014
35,35,"Brice Garnett",92,78,49,29,"TotalDrivingEfficiency",2014
36,36,"David Hearn",97,80,45,35,"TotalDrivingEfficiency",2014
37,37,"Bubba Watson",76,81,26,55,"TotalDrivingEfficiency",2014
38,38,"Ian Poulter",57,86,45,41,"TotalDrivingEfficiency",2014
39,39,"Jonas Blixt",64,87,67,20,"TotalDrivingEfficiency",2014
40,40,"Ryan Moore",86,92,78,14,"TotalDrivingEfficiency",2014
40,40,"Brandt Snedeker",89,92,37,55,"TotalDrivingEfficiency",2014
42,42,"Jamie Lovemark",64,93,29,64,"TotalDrivingEfficiency",2014
43,43,"Chris Stroud",88,97,70,27,"TotalDrivingEfficiency",2014
44,44,"Ben Curtis",77,99,66,33,"TotalDrivingEfficiency",2014
45,45,"Carl Pettersson",91,100,67,33,"TotalDrivingEfficiency",2014
46,46,"Richard Lee",80,103,40,63,"TotalDrivingEfficiency",2014
47,47,"David Lingmerth",80,104,31,73,"TotalDrivingEfficiency",2014
48,48,"Tim Clark",75,105,88,17,"TotalDrivingEfficiency",2014
49,49,"Brian Gay",81,108,86,22,"TotalDrivingEfficiency",2014
50,50,"Kevin Stadler",90,109,60,49,"TotalDrivingEfficiency",2014
51,51,"Roberto Castro",76,110,59,51,"TotalDrivingEfficiency",2014
51,51,"Louis Oosthuizen",50,110,75,35,"TotalDrivingEfficiency",2014
53,53,"Charley Hoffman",93,112,26,86,"TotalDrivingEfficiency",2014
54,54,"Tommy Gainey",73,113,60,53,"TotalDrivingEfficiency",2014
55,55,"Keegan Bradley",89,115,32,83,"TotalDrivingEfficiency",2014
55,55,"Bo Van Pelt",83,115,56,59,"TotalDrivingEfficiency",2014
57,57,"JJ Henry",91,116,43,73,"TotalDrivingEfficiency",2014
58,58,"Scott Brown",100,117,70,47,"TotalDrivingEfficiency",2014
58,58,"Russell Henley",92,117,14,103,"TotalDrivingEfficiency",2014
60,60,"James Hahn",82,118,40,78,"TotalDrivingEfficiency",2014
61,61,"Robert Allenby",83,119,84,35,"TotalDrivingEfficiency",2014
62,62,"Cameron Tringale",111,122,70,52,"TotalDrivingEfficiency",2014
63,63,"Rory McIlroy",66,125,64,61,"TotalDrivingEfficiency",2014
63,63,"Brendan Steele",89,125,47,78,"TotalDrivingEfficiency",2014
65,65,"KJ Choi",80,130,115,15,"TotalDrivingEfficiency",2014
66,66,"Tyrone Van Aswegen",79,134,56,78,"TotalDrivingEfficiency",2014
67,67,"Andres Romero",81,137,70,67,"TotalDrivingEfficiency",2014
68,68,"Chesson Hadley",84,141,74,67,"TotalDrivingEfficiency",2014
69,69,"Kyle Stanley",87,142,38,104,"TotalDrivingEfficiency",2014
70,70,"DH Lee",54,144,54,90,"TotalDrivingEfficiency",2014
71,71,"Graham DeLaet",80,145,36,109,"TotalDrivingEfficiency",2014
72,72,"Charles Howell III",106,147,69,78,"TotalDrivingEfficiency",2014
72,72,"David Toms",64,147,47,100,"TotalDrivingEfficiency",2014
74,74,"Matt Kuchar",91,149,92,57,"TotalDrivingEfficiency",2014
75,75,"Rickie Fowler",91,150,42,108,"TotalDrivingEfficiency",2014
75,75,"Justin Hicks",103,150,108,42,"TotalDrivingEfficiency",2014
77,77,"Troy Matteson",62,153,81,72,"TotalDrivingEfficiency",2014
78,78,"Brian Stuard",91,159,101,58,"TotalDrivingEfficiency",2014
79,79,"Lucas Glover",68,160,111,49,"TotalDrivingEfficiency",2014
79,79,"Andrew Loupe",65,160,53,107,"TotalDrivingEfficiency",2014
81,81,"Kevin Kisner",85,163,93,70,"TotalDrivingEfficiency",2014
82,82,"Steven Bowditch",93,165,101,64,"TotalDrivingEfficiency",2014
82,82,"Jim Herman",62,165,101,64,"TotalDrivingEfficiency",2014
82,82,"Jerry Kelly",80,165,123,42,"TotalDrivingEfficiency",2014
85,85,"Brad Fritsch",50,168,49,119,"TotalDrivingEfficiency",2014
86,86,"Danny Lee",84,172,86,86,"TotalDrivingEfficiency",2014
86,86,"Marc Leishman",81,172,75,97,"TotalDrivingEfficiency",2014
88,88,"Camilo Villegas",95,174,101,73,"TotalDrivingEfficiency",2014
89,89,"Kevin Streelman",79,176,77,99,"TotalDrivingEfficiency",2014
90,90,"Chad Campbell",57,177,91,86,"TotalDrivingEfficiency",2014
90,90,"DA Points",75,177,60,117,"TotalDrivingEfficiency",2014
92,92,"Robert Garrigus",80,179,65,114,"TotalDrivingEfficiency",2014
93,93,"Jason Kokrak",65,181,98,83,"TotalDrivingEfficiency",2014
93,93,"Phil Mickelson",71,181,28,153,"TotalDrivingEfficiency",2014
93,93,"Brendon Todd",108,181,122,59,"TotalDrivingEfficiency",2014
96,96,"Angel Cabrera",69,184,60,124,"TotalDrivingEfficiency",2014
97,97,"Daniel Summerhays",98,185,115,70,"TotalDrivingEfficiency",2014
98,98,"Rory Sabbatini",82,194,109,85,"TotalDrivingEfficiency",2014
99,99,"John Huh",87,195,95,100,"TotalDrivingEfficiency",2014
100,100,"Matt Jones",83,199,95,104,"TotalDrivingEfficiency",2014
101,101,"Johnson Wagner",69,200,89,111,"TotalDrivingEfficiency",2014
102,102,"Harris English",95,201,81,120,"TotalDrivingEfficiency",2014
103,103,"Scott Langley",95,204,169,35,"TotalDrivingEfficiency",2014
104,104,"Troy Merritt",62,208,115,93,"TotalDrivingEfficiency",2014
105,105,"Retief Goosen",94,209,84,125,"TotalDrivingEfficiency",2014
105,105,"Charlie Wi",72,209,123,86,"TotalDrivingEfficiency",2014
107,107,"Jonathan Byrd",76,215,78,137,"TotalDrivingEfficiency",2014
108,108,"Jeff Overton",80,217,141,76,"TotalDrivingEfficiency",2014
108,108,"Patrick Reed",92,217,81,136,"TotalDrivingEfficiency",2014
110,110,"Luke Guthrie",85,219,97,122,"TotalDrivingEfficiency",2014
111,111,"Justin Leonard",75,220,142,78,"TotalDrivingEfficiency",2014
112,112,"Jim Renner",61,221,90,131,"TotalDrivingEfficiency",2014
113,113,"Michael Thompson",74,226,93,133,"TotalDrivingEfficiency",2014
114,114,"Chad Collins",78,227,131,96,"TotalDrivingEfficiency",2014
114,114,"Jim Furyk",84,227,150,77,"TotalDrivingEfficiency",2014
116,116,"Shawn Stefani",60,230,101,129,"TotalDrivingEfficiency",2014
117,117,"Jason Bohn",81,231,129,102,"TotalDrivingEfficiency",2014
118,118,"Graeme McDowell",66,234,109,125,"TotalDrivingEfficiency",2014
118,118,"William McGirt",96,234,144,90,"TotalDrivingEfficiency",2014
118,118,"Will Wilcox",51,234,101,133,"TotalDrivingEfficiency",2014
121,121,"Bryce Molder",77,236,146,90,"TotalDrivingEfficiency",2014
122,122,"Brooks Koepka",56,238,78,160,"TotalDrivingEfficiency",2014
122,122,"Robert Streb",75,238,113,125,"TotalDrivingEfficiency",2014
124,124,"Lee Westwood",57,239,119,120,"TotalDrivingEfficiency",2014
125,125,"Woody Austin",63,244,127,117,"TotalDrivingEfficiency",2014
126,126,"Martin Kaymer",65,245,134,111,"TotalDrivingEfficiency",2014
127,127,"Billy Hurley III",86,249,154,95,"TotalDrivingEfficiency",2014
128,128,"Aaron Baddeley",74,250,98,152,"TotalDrivingEfficiency",2014
129,129,"Henrik Stenson",56,252,139,113,"TotalDrivingEfficiency",2014
130,130,"Kevin Chappell",100,254,115,139,"TotalDrivingEfficiency",2014
130,130,"John Merrick",87,254,160,94,"TotalDrivingEfficiency",2014
130,130,"John Peterson",62,254,111,143,"TotalDrivingEfficiency",2014
133,133,"Bronson La Cassie",51,258,119,139,"TotalDrivingEfficiency",2014
134,134,"Russell Knox",92,261,164,97,"TotalDrivingEfficiency",2014
135,135,"Luke Donald",57,262,101,161,"TotalDrivingEfficiency",2014
135,135,"Nick Watney",80,262,113,149,"TotalDrivingEfficiency",2014
137,137,"Seung Yul Noh",92,263,98,165,"TotalDrivingEfficiency",2014
138,138,"Erik Compton",88,265,123,142,"TotalDrivingEfficiency",2014
138,138,"Adam Scott",68,265,135,130,"TotalDrivingEfficiency",2014
138,138,"Andrew Svoboda",77,265,142,123,"TotalDrivingEfficiency",2014
141,141,"Greg Chalmers",85,272,158,114,"TotalDrivingEfficiency",2014
141,141,"Spencer Levin",59,272,168,104,"TotalDrivingEfficiency",2014
143,143,"Ben Martin",80,273,140,133,"TotalDrivingEfficiency",2014
144,144,"YE Yang",79,274,165,109,"TotalDrivingEfficiency",2014
145,145,"Hudson Swafford",75,275,121,154,"TotalDrivingEfficiency",2014
146,146,"Michael Putnam",106,279,136,143,"TotalDrivingEfficiency",2014
147,147,"Sangmoon Bae",76,282,151,131,"TotalDrivingEfficiency",2014
148,148,"Martin Flores",85,283,132,151,"TotalDrivingEfficiency",2014
149,149,"Boo Weekley",73,284,146,138,"TotalDrivingEfficiency",2014
150,150,"Matt Every",85,286,123,163,"TotalDrivingEfficiency",2014
151,151,"Jhonattan Vegas",77,287,128,159,"TotalDrivingEfficiency",2014
152,152,"Ken Duke",80,289,175,114,"TotalDrivingEfficiency",2014
153,153,"Derek Ernst",80,290,132,158,"TotalDrivingEfficiency",2014
154,154,"Kevin Na",94,291,148,143,"TotalDrivingEfficiency",2014
155,155,"Ted Potter Jr",68,295,156,139,"TotalDrivingEfficiency",2014
155,155,"Mike Weir",69,295,170,125,"TotalDrivingEfficiency",2014
155,155,"Gary Woodland",93,295,129,166,"TotalDrivingEfficiency",2014
158,158,"John Senden",99,297,154,143,"TotalDrivingEfficiency",2014
159,159,"George McNeill",79,305,156,149,"TotalDrivingEfficiency",2014
159,159,"John Rollins",84,305,144,161,"TotalDrivingEfficiency",2014
161,161,"Gonzalo Fdez Castano",83,306,138,168,"TotalDrivingEfficiency",2014
162,162,"Stuart Appleby",92,307,152,155,"TotalDrivingEfficiency",2014
163,163,"Stewart Cink",91,310,137,173,"TotalDrivingEfficiency",2014
164,164,"Kevin Tway",64,315,158,157,"TotalDrivingEfficiency",2014
165,165,"Ricky Barnes",92,320,173,147,"TotalDrivingEfficiency",2014
166,166,"Trevor Immelman",84,321,174,147,"TotalDrivingEfficiency",2014
167,167,"Ryo Ishikawa",75,322,153,169,"TotalDrivingEfficiency",2014
168,168,"Charlie Beljan",76,323,148,175,"TotalDrivingEfficiency",2014
169,169,"Charl Schwartzel",64,330,163,167,"TotalDrivingEfficiency",2014
170,170,"Jason Dufner",57,331,176,155,"TotalDrivingEfficiency",2014
171,171,"Briny Baird",50,333,170,163,"TotalDrivingEfficiency",2014
171,171,"Paul Casey",56,333,162,171,"TotalDrivingEfficiency",2014
173,173,"Pat Perez",84,334,165,169,"TotalDrivingEfficiency",2014
174,174,"James Driscoll",71,338,161,177,"TotalDrivingEfficiency",2014
175,175,"Sergio Garcia",61,340,165,175,"TotalDrivingEfficiency",2014
176,176,"Brendon de Jonge",109,344,172,172,"TotalDrivingEfficiency",2014
177,177,"Freddie Jacobson",91,351,177,174,"TotalDrivingEfficiency",2014
