"TotalDriving_RANKTHISWEEK_2007","TotalDriving_RANKLASTWEEK_2007","TotalDriving_PLAYERNAME_2007","TotalDriving_EVENTS_2007","TotalDriving_TOTAL_2007","TotalDriving_DISTANCERANK_2007","TotalDriving_ACCURACYRANK_2007","stat_name","year"
1,1,"Charles Warren",29,59,9,50,"TotalDriving",2007
2,2,"Mathew Goggin",30,70,26,44,"TotalDriving",2007
3,3,"Hunter Mahan",27,73,36,37,"TotalDriving",2007
4,4,"Jay Williamson",14,84,72,12,"TotalDriving",2007
5,5,"Kenny Perry",24,104,22,82,"TotalDriving",2007
6,6,"Cameron Beckman",29,109,69,40,"TotalDriving",2007
7,7,"Jason Gore",27,110,8,102,"TotalDriving",2007
8,8,"Sean OHair",28,113,34,79,"TotalDriving",2007
9,9,"John Senden",27,115,55,60,"TotalDriving",2007
10,10,"DJ Trahan",30,116,48,68,"TotalDriving",2007
11,11,"Boo Weekley",29,118,37,81,"TotalDriving",2007
12,12,"Bill Haas",30,120,11,109,"TotalDriving",2007
13,13,"Briny Baird",31,121,66,55,"TotalDriving",2007
14,14,"Jeff Overton",19,122,24,98,"TotalDriving",2007
15,15,"Matt Hendrix",24,129,15,114,"TotalDriving",2007
16,16,"Alex Cejka",25,130,94,36,"TotalDriving",2007
16,16,"Greg Owen",29,130,40,90,"TotalDriving",2007
18,18,"Peter Lonard",27,131,80,51,"TotalDriving",2007
19,19,"Jeff Brehaut",21,133,76,57,"TotalDriving",2007
20,20,"Lucas Glover",29,135,46,89,"TotalDriving",2007
20,20,"Billy Mayfair",30,135,117,18,"TotalDriving",2007
22,22,"Daisuke Maruyama",28,140,98,42,"TotalDriving",2007
22,22,"Chris Stroud",24,140,87,53,"TotalDriving",2007
24,24,"Ted Purdy",33,142,57,85,"TotalDriving",2007
25,25,"Kent Jones",30,143,111,32,"TotalDriving",2007
26,26,"Ken Duke",31,144,103,41,"TotalDriving",2007
26,26,"Joe Durant",28,144,139,5,"TotalDriving",2007
26,26,"Jim Rutledge",23,144,99,45,"TotalDriving",2007
29,29,"Michael Allen",22,146,61,85,"TotalDriving",2007
29,29,"Anthony Kim",26,146,12,134,"TotalDriving",2007
31,31,"Nick Watney",26,147,17,130,"TotalDriving",2007
32,32,"Jeff Gove",30,148,84,64,"TotalDriving",2007
32,32,"JJ Henry",26,148,54,94,"TotalDriving",2007
34,34,"Bubba Dickerson",19,149,25,124,"TotalDriving",2007
35,35,"Tommy Armour III",24,150,126,24,"TotalDriving",2007
35,35,"Rich Beem",29,150,79,71,"TotalDriving",2007
37,37,"Robert Allenby",28,154,22,132,"TotalDriving",2007
38,38,"David Branshaw",30,155,93,62,"TotalDriving",2007
39,39,"Steve Allan",18,156,12,144,"TotalDriving",2007
40,40,"Ryan Armour",32,157,135,22,"TotalDriving",2007
41,41,"John Merrick",29,158,33,125,"TotalDriving",2007
42,42,"Mark Calcavecchia",28,159,86,73,"TotalDriving",2007
43,43,"John Rollins",29,162,85,77,"TotalDriving",2007
43,43,"Jaco Van Zyl",21,162,131,31,"TotalDriving",2007
45,45,"Tiger Woods",16,164,12,152,"TotalDriving",2007
46,46,"Steve Marino",31,165,29,136,"TotalDriving",2007
47,47,"Pat Perez",27,166,37,129,"TotalDriving",2007
48,48,"Darron Stiles",24,167,134,33,"TotalDriving",2007
49,49,"Bo Van Pelt",30,168,50,118,"TotalDriving",2007
50,50,"Steve Lowery",22,169,67,102,"TotalDriving",2007
50,50,"Camilo Villegas",24,169,27,142,"TotalDriving",2007
52,52,"Mathias Gronberg",31,170,16,154,"TotalDriving",2007
53,53,"Tom Byrum",20,171,156,15,"TotalDriving",2007
53,53,"JB Holmes",24,171,3,168,"TotalDriving",2007
55,55,"Justin Leonard",29,173,148,25,"TotalDriving",2007
56,56,"Jim Furyk",23,174,171,3,"TotalDriving",2007
56,56,"Ryan Moore",28,174,82,92,"TotalDriving",2007
58,58,"Craig Barlow",16,176,45,131,"TotalDriving",2007
58,58,"Steve Wheatcroft",25,176,122,54,"TotalDriving",2007
58,58,"Charlie Wi",27,176,124,52,"TotalDriving",2007
61,61,"Zach Johnson",23,177,169,8,"TotalDriving",2007
61,61,"George McNeill",30,177,28,149,"TotalDriving",2007
61,61,"Shaun Micheel",29,177,138,39,"TotalDriving",2007
61,61,"Brett Wetterich",28,177,7,170,"TotalDriving",2007
61,61,"Mark Wilson",25,177,131,46,"TotalDriving",2007
66,66,"Steve Elkington",25,178,164,14,"TotalDriving",2007
66,66,"Adam Scott",19,178,18,160,"TotalDriving",2007
66,66,"Heath Slocum",28,178,172,6,"TotalDriving",2007
69,69,"Bart Bryant",25,179,160,19,"TotalDriving",2007
70,70,"Michael Boyd",21,180,176,4,"TotalDriving",2007
70,70,"Joey Sindelar",25,180,111,69,"TotalDriving",2007
72,72,"Tag Ridings",18,181,6,175,"TotalDriving",2007
72,72,"Jason Schultz",22,181,43,138,"TotalDriving",2007
72,72,"Duffy Waldorf",23,181,107,74,"TotalDriving",2007
75,75,"Chris Tidland",21,182,62,120,"TotalDriving",2007
76,76,"Jason Bohn",17,183,111,72,"TotalDriving",2007
77,77,"Glen Day",27,184,164,20,"TotalDriving",2007
77,77,"Chris Riley",17,184,167,17,"TotalDriving",2007
79,79,"Brian Davis",28,185,172,13,"TotalDriving",2007
79,79,"Troy Matteson",26,185,37,148,"TotalDriving",2007
81,81,"Robert Gamez",30,186,159,27,"TotalDriving",2007
81,81,"Tom Johnson",27,186,103,83,"TotalDriving",2007
83,83,"Paul Stankowski",18,188,43,145,"TotalDriving",2007
83,83,"Scott Verplank",23,188,172,16,"TotalDriving",2007
83,83,"Mike Weir",23,188,92,96,"TotalDriving",2007
86,86,"John Mallinger",29,189,163,26,"TotalDriving",2007
86,86,"Bubba Watson",26,189,1,188,"TotalDriving",2007
88,88,"Scott Gutschewski",22,190,5,185,"TotalDriving",2007
89,89,"Will Ma Kenzie",30,191,74,117,"TotalDriving",2007
89,89,"Justin Rose",16,191,96,95,"TotalDriving",2007
91,91,"Jose Coceres",17,192,191,1,"TotalDriving",2007
92,92,"Trevor Immelman",21,193,118,75,"TotalDriving",2007
93,93,"Fred Funk",22,195,193,2,"TotalDriving",2007
93,93,"JP Hayes",28,195,69,126,"TotalDriving",2007
93,93,"Charley Hoffman",30,195,19,176,"TotalDriving",2007
93,93,"Tripp Isenhour",32,195,111,84,"TotalDriving",2007
97,97,"Jerry Kelly",28,196,162,34,"TotalDriving",2007
98,98,"Craig Bowden",25,197,190,7,"TotalDriving",2007
98,98,"Robert Garrigus",28,197,4,193,"TotalDriving",2007
98,98,"Michael Sim",17,197,78,119,"TotalDriving",2007
101,101,"John Daly",24,198,2,196,"TotalDriving",2007
101,101,"Doug LaBelle II",33,198,187,11,"TotalDriving",2007
101,101,"Jarrod Lyle",24,198,65,133,"TotalDriving",2007
104,104,"Mark Brooks",18,199,189,10,"TotalDriving",2007
104,104,"Harrison Frazar",32,199,9,190,"TotalDriving",2007
106,106,"Michael Putnam",29,200,53,147,"TotalDriving",2007
107,107,"Stephen Ames",23,201,154,47,"TotalDriving",2007
108,108,"Chris Couch",30,202,20,182,"TotalDriving",2007
108,108,"Kyle Reifers",27,202,41,161,"TotalDriving",2007
108,108,"Kirk Triplett",25,202,181,21,"TotalDriving",2007
111,111,"Brian Gay",32,203,194,9,"TotalDriving",2007
111,111,"Davis Love III",21,203,34,169,"TotalDriving",2007
111,111,"Kevin Stadler",31,203,62,141,"TotalDriving",2007
114,114,"Jeff Maggert",26,205,142,63,"TotalDriving",2007
114,114,"Tom Pernice Jr",31,205,156,49,"TotalDriving",2007
116,116,"Tim Clark",19,206,178,28,"TotalDriving",2007
117,117,"Steve Flesch",31,207,107,100,"TotalDriving",2007
117,117,"Frank Lickliter II",30,207,142,65,"TotalDriving",2007
119,119,"DJ Brigman",22,210,94,116,"TotalDriving",2007
119,119,"Ernie Els",16,210,31,179,"TotalDriving",2007
119,119,"Phil Mickelson",22,210,29,181,"TotalDriving",2007
122,122,"Bob Heintz",27,211,133,78,"TotalDriving",2007
123,123,"Luke Donald",20,212,177,35,"TotalDriving",2007
123,123,"Anders Hansen",17,212,164,48,"TotalDriving",2007
123,123,"Geoff Ogilvy",22,212,47,165,"TotalDriving",2007
123,123,"Kevin Sutherland",25,212,75,137,"TotalDriving",2007
127,127,"Jeff Quinney",29,213,155,58,"TotalDriving",2007
127,127,"Vijay Singh",27,213,58,155,"TotalDriving",2007
129,129,"Jesper Parnevik",27,214,99,115,"TotalDriving",2007
130,130,"Aaron Baddeley",23,215,69,146,"TotalDriving",2007
130,130,"Charles Howell III",26,215,20,195,"TotalDriving",2007
132,132,"Jonathan Byrd",23,216,67,149,"TotalDriving",2007
132,132,"Mark Hensby",25,216,115,101,"TotalDriving",2007
132,132,"Rocco Mediate",22,216,178,38,"TotalDriving",2007
135,135,"Brendon de Jonge",26,217,58,159,"TotalDriving",2007
135,135,"Johnson Wagner",33,217,129,88,"TotalDriving",2007
137,137,"Gavin Coles",28,218,195,23,"TotalDriving",2007
137,137,"Joe Ogilvie",31,218,91,127,"TotalDriving",2007
139,139,"Bob Estes",28,219,149,70,"TotalDriving",2007
140,140,"Stuart Appleby",24,220,80,140,"TotalDriving",2007
141,141,"Andrew Buckle",26,221,50,171,"TotalDriving",2007
141,141,"Daniel Chopra",34,221,32,189,"TotalDriving",2007
141,141,"Paul Goydos",19,221,192,29,"TotalDriving",2007
141,141,"Rod Pampling",25,221,119,102,"TotalDriving",2007
141,141,"Henrik Stenson",15,221,41,180,"TotalDriving",2007
146,146,"Kevin Na",27,222,109,113,"TotalDriving",2007
146,146,"Ryan Palmer",30,222,49,173,"TotalDriving",2007
148,148,"KJ Choi",25,223,144,79,"TotalDriving",2007
149,149,"Chad Campbell",28,225,115,110,"TotalDriving",2007
149,149,"Jason Dufner",32,225,90,135,"TotalDriving",2007
151,151,"Richard Johnson",32,226,160,66,"TotalDriving",2007
151,151,"Corey Pavin",25,226,196,30,"TotalDriving",2007
151,151,"David Toms",22,226,151,75,"TotalDriving",2007
154,154,"Woody Austin",27,227,122,105,"TotalDriving",2007
155,155,"Ben Curtis",25,228,185,43,"TotalDriving",2007
155,155,"Tom Lehman",19,228,137,91,"TotalDriving",2007
157,157,"Tim Herron",27,232,110,122,"TotalDriving",2007
158,158,"Stewart Cink",25,233,50,183,"TotalDriving",2007
159,159,"Padraig Harrington",18,234,60,174,"TotalDriving",2007
159,159,"Freddie Jacobson",20,234,135,99,"TotalDriving",2007
159,159,"Vaughn Taylor",28,234,147,87,"TotalDriving",2007
162,162,"Paul Gow",26,237,170,67,"TotalDriving",2007
163,163,"Marco Dawson",23,238,89,149,"TotalDriving",2007
164,164,"Brian Bateman",18,239,72,167,"TotalDriving",2007
164,164,"Sergio Garcia",19,239,55,184,"TotalDriving",2007
166,166,"Matt Kuchar",26,241,185,56,"TotalDriving",2007
167,167,"Craig Kanada",34,242,183,59,"TotalDriving",2007
168,168,"Stephen Leaney",26,243,182,61,"TotalDriving",2007
168,168,"Steve Stricker",23,243,146,97,"TotalDriving",2007
170,170,"Rory Sabbatini",23,250,88,162,"TotalDriving",2007
171,171,"Craig Lile",24,251,145,106,"TotalDriving",2007
172,172,"Arron Oberholser",21,252,129,123,"TotalDriving",2007
173,173,"Retief Goosen",14,254,62,192,"TotalDriving",2007
174,174,"Cliff Kresge",30,255,127,128,"TotalDriving",2007
175,175,"Carl Pettersson",31,256,99,157,"TotalDriving",2007
176,176,"Ian Poulter",18,258,151,107,"TotalDriving",2007
177,177,"Nathan Green",29,259,139,120,"TotalDriving",2007
178,178,"Tim Petrovic",32,262,119,143,"TotalDriving",2007
179,179,"Bryce Molder",21,267,76,191,"TotalDriving",2007
180,180,"Lee Janzen",24,268,105,163,"TotalDriving",2007
180,180,"Dicky Pride",25,268,156,112,"TotalDriving",2007
180,180,"Brett Quigley",25,268,82,186,"TotalDriving",2007
183,183,"Todd Hamilton",28,273,96,177,"TotalDriving",2007
184,184,"Dean Wilson",28,275,183,92,"TotalDriving",2007
185,185,"Billy Andrade",27,277,121,156,"TotalDriving",2007
185,185,"Parker McLachlin",28,277,99,178,"TotalDriving",2007
187,187,"Bob Tway",32,278,139,139,"TotalDriving",2007
188,188,"Brandt Snedeker",29,280,127,153,"TotalDriving",2007
189,189,"Nick OHern",22,286,175,111,"TotalDriving",2007
190,190,"Shigeki Maruyama",31,288,180,108,"TotalDriving",2007
191,191,"Eric Axley",36,293,106,187,"TotalDriving",2007
192,192,"Rich Barcelo",26,296,124,172,"TotalDriving",2007
193,193,"Ryuji Imada",32,315,149,166,"TotalDriving",2007
194,194,"Chris DiMarco",24,317,153,164,"TotalDriving",2007
195,195,"Jeff Sluman",21,325,168,157,"TotalDriving",2007
196,196,"Jose Maria Olazabal",16,382,188,194,"TotalDriving",2007
