"TotalDriving_RANKTHISWEEK_2009","TotalDriving_RANKLASTWEEK_2009","TotalDriving_PLAYERNAME_2009","TotalDriving_EVENTS_2009","TotalDriving_TOTAL_2009","TotalDriving_DISTANCERANK_2009","TotalDriving_ACCURACYRANK_2009","stat_name","year"
1,1,"Jonathan Byrd",25,92,33,59,"TotalDriving",2009
2,2,"Lucas Glover",26,95,25,70,"TotalDriving",2009
3,3,"Kenny Perry",24,97,48,49,"TotalDriving",2009
3,3,"John Rollins",27,97,30,67,"TotalDriving",2009
5,5,"Robert Allenby",21,98,48,50,"TotalDriving",2009
5,5,"Boo Weekley",22,98,62,36,"TotalDriving",2009
7,7,"Hunter Mahan",25,102,28,74,"TotalDriving",2009
8,8,"Ryan Moore",27,104,33,71,"TotalDriving",2009
8,8,"Greg Owen",30,104,59,45,"TotalDriving",2009
8,8,"Heath Slocum",30,104,97,7,"TotalDriving",2009
11,11,"Kirk Triplett",20,105,100,5,"TotalDriving",2009
12,12,"Tiger Woods",17,107,21,86,"TotalDriving",2009
13,13,"Charles Warren",20,111,18,93,"TotalDriving",2009
14,14,"Scott McCarron",27,117,114,3,"TotalDriving",2009
15,15,"John Senden",29,118,40,78,"TotalDriving",2009
16,16,"Michael Allen",22,119,80,39,"TotalDriving",2009
17,17,"Martin Laird",24,121,14,107,"TotalDriving",2009
17,17,"Jeff Maggert",28,121,83,38,"TotalDriving",2009
19,19,"Kris Blanks",20,122,65,57,"TotalDriving",2009
20,20,"David Toms",27,123,119,4,"TotalDriving",2009
21,21,"Bo Van Pelt",30,124,56,68,"TotalDriving",2009
22,22,"Jason Bohn",25,126,108,18,"TotalDriving",2009
22,22,"DJ Trahan",30,126,79,47,"TotalDriving",2009
24,24,"Tommy Armour III",19,129,95,34,"TotalDriving",2009
24,24,"Nicholas Thompson",31,129,38,91,"TotalDriving",2009
26,26,"Mathew Goggin",26,131,69,62,"TotalDriving",2009
27,27,"Jason Gore",24,132,72,60,"TotalDriving",2009
27,27,"Bill Haas",29,132,22,110,"TotalDriving",2009
29,29,"Ted Purdy",30,134,45,89,"TotalDriving",2009
30,30,"Steve Marino",29,139,35,104,"TotalDriving",2009
30,30,"Billy Mayfair",28,139,119,20,"TotalDriving",2009
32,32,"Will Ma Kenzie",24,140,78,62,"TotalDriving",2009
33,33,"Steve Elkington",23,142,107,35,"TotalDriving",2009
34,34,"Steve Lowery",27,143,74,69,"TotalDriving",2009
35,35,"Peter Tomasulo",25,144,50,94,"TotalDriving",2009
36,36,"Ernie Els",19,145,68,77,"TotalDriving",2009
37,37,"Troy Matteson",30,146,9,137,"TotalDriving",2009
37,37,"Mark Wilson",28,146,118,28,"TotalDriving",2009
39,39,"Jason Dufner",26,148,102,46,"TotalDriving",2009
40,40,"Bill Lunde",27,149,57,92,"TotalDriving",2009
40,40,"Jay Williamson",22,149,123,26,"TotalDriving",2009
42,42,"Ben Crane",27,150,109,41,"TotalDriving",2009
43,43,"Tim Clark",23,152,150,2,"TotalDriving",2009
44,44,"Zach Johnson",26,153,143,10,"TotalDriving",2009
45,45,"John Merrick",28,154,29,125,"TotalDriving",2009
45,45,"Ryan Palmer",26,154,26,128,"TotalDriving",2009
47,47,"Justin Leonard",26,155,123,32,"TotalDriving",2009
48,48,"Sergio Garcia",17,156,18,138,"TotalDriving",2009
48,48,"Scott Verplank",24,156,145,11,"TotalDriving",2009
50,50,"Davis Love III",27,157,14,143,"TotalDriving",2009
50,50,"Steve Stricker",22,157,104,53,"TotalDriving",2009
52,52,"Joe Durant",20,158,157,1,"TotalDriving",2009
52,52,"Marc Leishman",28,158,17,141,"TotalDriving",2009
54,54,"Kevin Streelman",29,159,30,129,"TotalDriving",2009
55,55,"Jeff Klauk",29,160,147,13,"TotalDriving",2009
55,55,"Matt Weibring",22,160,84,76,"TotalDriving",2009
57,57,"Nick Watney",24,161,6,155,"TotalDriving",2009
58,58,"Robert Garrigus",25,162,1,161,"TotalDriving",2009
58,58,"Patrick Sheehan",15,162,146,16,"TotalDriving",2009
60,60,"Charlie Wi",28,164,112,52,"TotalDriving",2009
61,61,"Darron Stiles",20,165,153,12,"TotalDriving",2009
62,62,"Stephen Ames",23,167,94,73,"TotalDriving",2009
62,62,"Alex Cejka",25,167,143,24,"TotalDriving",2009
62,62,"Charley Hoffman",27,167,11,156,"TotalDriving",2009
65,65,"Kent Jones",24,168,141,27,"TotalDriving",2009
66,66,"Sean OHair",23,169,46,123,"TotalDriving",2009
66,66,"Tag Ridings",16,169,4,165,"TotalDriving",2009
66,66,"Justin Rose",22,169,90,79,"TotalDriving",2009
69,69,"JJ Henry",28,171,44,127,"TotalDriving",2009
70,70,"Jason Day",18,172,36,136,"TotalDriving",2009
70,70,"Dustin Johnson",25,172,3,169,"TotalDriving",2009
70,70,"Vijay Singh",21,172,41,131,"TotalDriving",2009
70,70,"Chris Stroud",28,172,72,100,"TotalDriving",2009
70,70,"Johnson Wagner",26,172,88,84,"TotalDriving",2009
75,75,"Chad Campbell",26,173,70,103,"TotalDriving",2009
75,75,"Chez Reavie",27,173,154,19,"TotalDriving",2009
77,77,"James Nitties",27,174,63,111,"TotalDriving",2009
78,78,"Chris Riley",22,176,167,9,"TotalDriving",2009
78,78,"Camilo Villegas",21,176,50,126,"TotalDriving",2009
80,80,"Bob Estes",23,177,137,40,"TotalDriving",2009
80,80,"Jim Furyk",23,177,152,25,"TotalDriving",2009
80,80,"Colt Knost",24,177,154,23,"TotalDriving",2009
80,80,"Michael Letzig",28,177,43,134,"TotalDriving",2009
84,84,"Brian Davis",32,178,127,51,"TotalDriving",2009
84,84,"DA Points",29,178,141,37,"TotalDriving",2009
86,86,"Scott Piercy",28,179,12,167,"TotalDriving",2009
87,87,"Bubba Watson",24,180,2,178,"TotalDriving",2009
88,88,"Harrison Frazar",28,182,10,172,"TotalDriving",2009
88,88,"Gary Woodland",18,182,5,177,"TotalDriving",2009
90,90,"Bart Bryant",17,183,175,8,"TotalDriving",2009
91,91,"Daniel Chopra",28,185,26,159,"TotalDriving",2009
91,91,"Adam Scott",19,185,37,148,"TotalDriving",2009
91,91,"Vaughn Taylor",28,185,129,56,"TotalDriving",2009
94,94,"Briny Baird",28,186,138,48,"TotalDriving",2009
95,95,"Bob Heintz",20,187,123,64,"TotalDriving",2009
95,95,"Rod Pampling",23,187,90,97,"TotalDriving",2009
97,97,"Stewart Cink",22,188,39,149,"TotalDriving",2009
97,97,"Tim Petrovic",31,188,133,55,"TotalDriving",2009
99,99,"Angel Cabrera",17,189,8,181,"TotalDriving",2009
99,99,"Brian Gay",27,189,183,6,"TotalDriving",2009
101,101,"Fred Couples",16,190,24,166,"TotalDriving",2009
101,101,"Brandt Snedeker",26,190,169,21,"TotalDriving",2009
103,103,"JB Holmes",25,191,7,184,"TotalDriving",2009
103,103,"Anthony Kim",22,191,16,175,"TotalDriving",2009
103,103,"Brian Vranesh",20,191,89,102,"TotalDriving",2009
103,103,"Casey Wittenberg",25,191,109,82,"TotalDriving",2009
107,107,"Matt Jones",17,192,23,169,"TotalDriving",2009
107,107,"Phil Mickelson",18,192,13,179,"TotalDriving",2009
107,107,"Kevin Stadler",20,192,75,117,"TotalDriving",2009
107,107,"Kevin Sutherland",27,192,80,112,"TotalDriving",2009
111,111,"KJ Choi",22,193,150,43,"TotalDriving",2009
111,111,"Jerry Kelly",26,193,114,79,"TotalDriving",2009
113,113,"Matt Kuchar",24,194,128,66,"TotalDriving",2009
113,113,"Bryce Molder",21,194,129,65,"TotalDriving",2009
115,115,"Glen Day",26,195,174,21,"TotalDriving",2009
115,115,"John Mallinger",27,195,164,31,"TotalDriving",2009
117,117,"Brendon de Jonge",29,196,75,121,"TotalDriving",2009
117,117,"Todd Hamilton",29,196,113,83,"TotalDriving",2009
117,117,"Tom Lehman",16,196,179,17,"TotalDriving",2009
117,117,"George McNeill",26,196,61,135,"TotalDriving",2009
117,117,"Pat Perez",22,196,87,109,"TotalDriving",2009
122,122,"Woody Austin",24,197,99,98,"TotalDriving",2009
122,122,"Mark Brooks",17,197,182,15,"TotalDriving",2009
122,122,"Retief Goosen",20,197,58,139,"TotalDriving",2009
125,125,"Leif Olson",21,198,30,168,"TotalDriving",2009
125,125,"Corey Pavin",23,198,184,14,"TotalDriving",2009
125,125,"Andres Romero",20,198,18,180,"TotalDriving",2009
128,128,"Charles Howell III",29,199,53,146,"TotalDriving",2009
128,128,"Nick OHern",27,199,170,29,"TotalDriving",2009
130,130,"YE Yang",23,200,67,133,"TotalDriving",2009
131,131,"Matt Bettencourt",31,201,52,149,"TotalDriving",2009
131,131,"Rory Sabbatini",25,201,47,154,"TotalDriving",2009
133,133,"Paul Goydos",25,202,172,30,"TotalDriving",2009
134,134,"Rich Beem",26,203,114,89,"TotalDriving",2009
134,134,"Scott Sterling",16,203,109,94,"TotalDriving",2009
136,136,"Ricky Barnes",23,207,55,152,"TotalDriving",2009
137,137,"Ian Poulter",17,208,133,75,"TotalDriving",2009
138,138,"Richard Johnson",26,209,176,33,"TotalDriving",2009
139,139,"Rick Price",21,210,166,44,"TotalDriving",2009
140,140,"Chris DiMarco",29,211,157,54,"TotalDriving",2009
141,141,"Tim Herron",27,212,59,153,"TotalDriving",2009
142,142,"Geoff Ogilvy",20,214,63,151,"TotalDriving",2009
143,143,"Cameron Beckman",26,215,97,118,"TotalDriving",2009
143,143,"Peter Lonard",30,215,157,58,"TotalDriving",2009
143,143,"Jeff Overton",28,215,41,174,"TotalDriving",2009
146,146,"Rocco Mediate",22,217,129,88,"TotalDriving",2009
147,147,"Greg Chalmers",26,218,119,99,"TotalDriving",2009
147,147,"Marc Turnesa",30,218,157,61,"TotalDriving",2009
149,149,"Stuart Appleby",25,219,77,142,"TotalDriving",2009
149,149,"Jarrod Lyle",21,219,95,124,"TotalDriving",2009
149,149,"Jeff Quinney",26,219,177,42,"TotalDriving",2009
152,152,"Cliff Kresge",28,221,149,72,"TotalDriving",2009
153,153,"Joe Ogilvie",29,223,65,158,"TotalDriving",2009
154,154,"Steve Flesch",27,225,117,108,"TotalDriving",2009
155,155,"Tom Pernice Jr",26,226,140,86,"TotalDriving",2009
156,156,"Mark Calcavecchia",23,234,104,130,"TotalDriving",2009
157,157,"David Duval",22,236,53,183,"TotalDriving",2009
158,158,"Brett Quigley",28,237,93,144,"TotalDriving",2009
159,159,"Ben Curtis",18,238,157,81,"TotalDriving",2009
160,160,"Kevin Na",26,240,136,104,"TotalDriving",2009
161,161,"Brad Adamonis",25,242,82,160,"TotalDriving",2009
161,161,"Ken Duke",29,242,129,113,"TotalDriving",2009
161,161,"Webb Simpson",30,242,102,140,"TotalDriving",2009
164,164,"Carl Pettersson",29,243,86,157,"TotalDriving",2009
165,165,"Jimmy Walker",24,246,70,176,"TotalDriving",2009
166,166,"Brian Bateman",25,248,84,164,"TotalDriving",2009
167,167,"Aron Price",27,250,154,96,"TotalDriving",2009
168,168,"Lee Janzen",23,254,139,115,"TotalDriving",2009
169,169,"Aaron Baddeley",23,255,92,163,"TotalDriving",2009
169,169,"Nathan Green",30,255,123,132,"TotalDriving",2009
171,171,"Derek Fathauer",25,262,100,162,"TotalDriving",2009
172,172,"David Mathis",27,264,148,116,"TotalDriving",2009
173,173,"Dean Wilson",29,266,181,85,"TotalDriving",2009
174,174,"Freddie Jacobson",25,269,122,147,"TotalDriving",2009
174,174,"Mike Weir",24,269,163,106,"TotalDriving",2009
176,176,"Padraig Harrington",20,277,106,171,"TotalDriving",2009
177,177,"Greg Kraft",21,279,178,101,"TotalDriving",2009
178,178,"Spencer Levin",25,284,165,119,"TotalDriving",2009
179,179,"Luke Donald",21,287,173,114,"TotalDriving",2009
180,180,"Ryuji Imada",25,290,168,122,"TotalDriving",2009
181,181,"Brendon Todd",21,291,171,120,"TotalDriving",2009
182,182,"Eric Axley",30,315,133,182,"TotalDriving",2009
183,183,"Brad Faxon",23,324,180,144,"TotalDriving",2009
184,184,"Parker McLachlin",25,330,157,173,"TotalDriving",2009
